x=33.y=17
———————————————————————————————————
|@@@@@@@@             @     @  @   |
|@@@@@@@@    @  @            @   ##|
|@@@@@@                          ##|
|@@@@@@            ####  ######    |
|@@@@        @  ####       ————————|
|@@             ##     @  |  @    >|
|               ##        |      >>|
|    @             ##     |      >>|
|          @              |     >>>|
|                  ##          @  >|
|  @               ##     |        |
|       @        ##       |   @  ——|
|                         |      ##|
|   @         ###          ————————|
|          ###       @        #####|
|       ####     @          #######|  
|      ###              @ #########|
———————————————————————————————————